111111111111
110000000011
100100000001
101C11C0C0C1
100000100C11
1C1111001111
1100000C0001
10000C000001
100000000001
101111111111
10000P0000E1
111111111111