111111111111
11P000000011
100000000001
10C00C0C0C01
1C0000C000C1
111100001111
1C00000000C1
10000C0C0001
100000000001
101111111111
1000000000E1
111111111111