11111
1PC01
10001
10C01
100E1
11111