11111111111111111111111111111111111111111111111111111
111111P1000000000000000000000000000000000000000000001
11111001000000000000000000000000000000000000000000001
11110010000000000000000000000000000000000000000000001
11100100000000000000000000000000000000000000000000001
11001000000000000000000000000000000000000000000000001
10010000000000000000000000000000000000000000000000001
10100000000000000000000000000000000000000000000000101
10000000000000000000000000000000000000000000000001001
10100000000000000000000000000000000000000000000010001
1001000000000000000000000000000000000000000000001E001
11001000000000000000000000000000000000000000000010001
11100100000000000000000000000000000000000000000001001
1C110100000000000000000000000000000000000000000000101
10110010000000000000000000000000000000000000000000001
100110010000000000000001C0000000000000000000000000001
1101110010000000000000011C000000000000000000000000001
10C0C010110000000000000111C00000000000000000000000001
10C0C0100110000000000001111C0000000000000000000000001
10C0C01000111101111111011111C000000000000000000000001
10C0C0001000000C111111C111111C00000000000000000000001
11111111111111111111111111111111111111111111111111111